C 10,60,80
NO ./textures/TECH_1.png
SO ./textures/TECH_2.png

WE ./textures/TECH_3.png
EA ./textures/TECH_4.png
F 125,0,125

        111111111111111111111111111111111
        100100000001000000000000000000001
        100000000001000000000N00000000001
        100100000001000000000000000000001
1111111100010000000000000000000000000000111111
10000000000100000001000000000111000110000000011
1000000000010000000100000000000000011111111111
100011101111111111110000000000111001
1111000000000000000000000000000010001
1111000000000000000000000000000010001
1111000000000000000000000000000010001
10000001110000011110000000000000000011
11000001  100001 10111111111111000001
11111111  111111 111          1111111
