C 10,60,80
NO ./textures/huge_1.png
SO ./textures/wall.png

WE ./textures/huge_4.png
EA ./textures/huge_2.png
F 125,0,125

        111111111111111111111111111111111
        100100000001000000000000000000001
        100000000001000000000000000000001
        100100000001000000000000000000001
11111111000100000000000000000000000000001
10000000000100000001000000000111000110011
100000000001000000010000000000000001111
100011101111111111110000000000111001
1111000000000000000000000000000010001
100000000000000000000000000000010001
10000000000000000N0000000000000010001
1000000000000000000000000000001000001
10000001110000011110000000000000000011
11000001  100001 10111111111111000001
11111111  111111 111          1111111