C 30,60,50
NO ./textures/TECH_1.png
SO ./textures/TECH_2.png

WE ./textures/TECH_3.png
EA ./textures/TECH_4.png
F 50,0,125

        111111111111111111111111111111111
        100100000001000000000000000000001
        100000000001000000000N00000000001
        100100000000000000000000000000001
11111111000100000000001000000000000000001111111111111
1100000000001000000000000111111100000111000110000000011
1000000000010000000000001     10000000000011111111111
1000111011111111111000001     1000000111001
1111000000000000000000001     10000000010001
1111000000000000000000001     10000000010001
11110000000000000000000011111110000000010001
1000000111000001111000000000000000001111111
11000001  100001 10111111111111000001
11111111  111111 111          1111111

